211111111111111111112
100000000000000000001
100000000000000000001
100000000000000000001
100000000010000000001
100000000010000000001
100000000010000000001
100000000010000000001
100000000010000000001
100000000010000000001
100011111111111110001
100000000010000000001
100000000010000000001
100000000010000000001
100000000010000000001
100000000010000000001
100000000010000000001
100000000000000000001
100000000344000000001
100000000000000000001
211111111111111111112