211111111111111111112
100000000000000000001
100000000000000000001
100111100000001111001
100100000000000001001
100100000000000001001
100100000000000001001
100000000000000000001
100000000000000000001
100000000222000000001
100000000222000000001
100000000222000000001
100000000000000000001
100000000000000000001
100100000344000001001
100100000000000001001
100100000000000001001
100111100000001111001
100000000000000000001
100000000000000000001
211111111111111111112