211111111111111111112
100000000000000000001
100000000001110000001
100001000000000000001
100000000000000000001
100000000000000000001
100000000000001000001
100000010000000000001
100000000000000000001
100000000344000001001
100100000000000001001
100110000000000001001
100000000011100000001
100000000000000000001
100000000000000000001
100000100000000000001
100000000000011000001
100000000000011000001
100000000000000000001
100000000000000000001
211111111111111111112