211111111111111111112
100000000000000000001
101111111101111111101
101000000000000000101
101011111101111110101
101010000000000010101
101010111101111010101
101010100000001010101
101010101101101010101
101010101000101010101
100000000010000000001
101010101000101010101
101010101101101010101
101010100000001010101
101010111101111010101
101010000000000010101
101011111101111110101
101000000000000000101
101111111101111111101
100000000344000000001
211111111111111111112